[
  {
    "name": "Diamond Emblem",
    "width": 5,
    "height": 5,
    "solutionGrid": [
      [0, 0, 1, 0, 0],
      [0, 1, 1, 1, 0],
      [1, 1, 0, 1, 1],
      [0, 1, 1, 1, 0],
      [0, 0, 1, 0, 0]
    ],
    "active": false,
    "approved": false
  },
  {
    "name": "Plus Sign",
    "width": 5,
    "height": 5,
    "solutionGrid": [
      [0, 0, 1, 0, 0],
      [0, 0, 1, 0, 0],
      [1, 1, 1, 1, 1],
      [0, 0, 1, 0, 0],
      [0, 0, 1, 0, 0]
    ],
    "active": false,
    "approved": false
  },
  {
    "name": "Crystalline Spark",
    "width": 5,
    "height": 5,
    "solutionGrid": [
      [0, 1, 0, 1, 0],
      [1, 0, 1, 0, 1],
      [0, 1, 0, 1, 0],
      [1, 0, 1, 0, 1],
      [0, 1, 0, 1, 0]
    ],
    "active": false,
    "approved": false
  },
  {
    "name": "Hourglass",
    "width": 5,
    "height": 5,
    "solutionGrid": [
      [1, 1, 1, 1, 1],
      [0, 1, 1, 1, 0],
      [0, 0, 1, 0, 0],
      [0, 1, 1, 1, 0],
      [1, 1, 1, 1, 1]
    ],
    "active": false,
    "approved": false
  },
  {
    "name": "Smile Face",
    "width": 10,
    "height": 10,
    "solutionGrid": [
      [0, 0, 0, 0, 0, 0, 0, 0, 0, 0],
      [0, 0, 1, 1, 0, 0, 1, 1, 0, 0],
      [0, 0, 1, 1, 0, 0, 1, 1, 0, 0],
      [0, 0, 0, 0, 0, 0, 0, 0, 0, 0],
      [0, 0, 0, 0, 1, 1, 0, 0, 0, 0],
      [0, 0, 0, 0, 1, 1, 0, 0, 0, 0],
      [0, 0, 0, 0, 0, 0, 0, 0, 0, 0],
      [0, 1, 0, 0, 0, 0, 0, 0, 1, 0],
      [0, 1, 1, 1, 1, 1, 1, 1, 1, 0],
      [0, 0, 0, 0, 0, 0, 0, 0, 0, 0]
    ],
    "active": false,
    "approved": false
  },
  {
    "name": "Ascending Star",
    "width": 15,
    "height": 15,
    "solutionGrid": [
      [0,0,0,0,0,0,0,1,0,0,0,0,0,0,0],
      [0,0,0,0,0,0,1,1,1,0,0,0,0,0,0],
      [0,0,0,0,0,1,1,1,1,1,0,0,0,0,0],
      [1,1,1,1,1,1,1,1,1,1,1,1,1,1,1],
      [0,1,1,1,1,1,1,1,1,1,1,1,1,1,0],
      [0,0,1,1,1,1,1,1,1,1,1,1,1,0,0],
      [0,0,0,1,1,1,1,1,1,1,1,1,0,0,0],
      [0,0,0,0,1,1,1,1,1,1,1,0,0,0,0],
      [0,0,0,0,1,1,1,1,1,1,1,0,0,0,0],
      [0,0,0,1,1,1,1,0,1,1,1,1,0,0,0],
      [0,0,1,1,1,1,0,0,0,1,1,1,1,0,0],
      [0,1,1,1,0,0,0,0,0,0,0,1,1,1,0],
      [1,1,1,0,0,0,0,0,0,0,0,0,1,1,1],
      [1,1,0,0,0,0,0,0,0,0,0,0,0,1,1],
      [0,0,0,0,0,0,0,0,0,0,0,0,0,0,0]
    ],
    "active": false,
    "approved": false
  },
  {
    "name": "Hollow Square 20x20",
    "width": 20,
    "height": 20,
    "solutionGrid": [
      [1,1,1,1,1,1,1,1,1,1,1,1,1,1,1,1,1,1,1,1],
      [1,0,0,0,0,0,0,0,0,0,0,0,0,0,0,0,0,0,0,1],
      [1,0,0,0,0,0,0,0,0,0,0,0,0,0,0,0,0,0,0,1],
      [1,0,0,0,0,0,0,0,0,0,0,0,0,0,0,0,0,0,0,1],
      [1,0,0,0,0,0,0,0,0,0,0,0,0,0,0,0,0,0,0,1],
      [1,0,0,0,0,0,0,0,0,0,0,0,0,0,0,0,0,0,0,1],
      [1,0,0,0,0,0,0,0,0,0,0,0,0,0,0,0,0,0,0,1],
      [1,0,0,0,0,0,0,0,0,0,0,0,0,0,0,0,0,0,0,1],
      [1,0,0,0,0,0,0,0,0,0,0,0,0,0,0,0,0,0,0,1],
      [1,0,0,0,0,0,0,0,0,0,0,0,0,0,0,0,0,0,0,1],
      [1,0,0,0,0,0,0,0,0,0,0,0,0,0,0,0,0,0,0,1],
      [1,0,0,0,0,0,0,0,0,0,0,0,0,0,0,0,0,0,0,1],
      [1,0,0,0,0,0,0,0,0,0,0,0,0,0,0,0,0,0,0,1],
      [1,0,0,0,0,0,0,0,0,0,0,0,0,0,0,0,0,0,0,1],
      [1,0,0,0,0,0,0,0,0,0,0,0,0,0,0,0,0,0,0,1],
      [1,0,0,0,0,0,0,0,0,0,0,0,0,0,0,0,0,0,0,1],
      [1,0,0,0,0,0,0,0,0,0,0,0,0,0,0,0,0,0,0,1],
      [1,0,0,0,0,0,0,0,0,0,0,0,0,0,0,0,0,0,0,1],
      [1,0,0,0,0,0,0,0,0,0,0,0,0,0,0,0,0,0,0,1],
      [1,1,1,1,1,1,1,1,1,1,1,1,1,1,1,1,1,1,1,1]
    ],
    "active": false,
    "approved": false
  },
  {
    "name": "Hollow Square 30x30",
    "width": 30,
    "height": 30,
    "solutionGrid": [
      [1,1,1,1,1,1,1,1,1,1,1,1,1,1,1,1,1,1,1,1,1,1,1,1,1,1,1,1,1,1],
      [1,0,0,0,0,0,0,0,0,0,0,0,0,0,0,0,0,0,0,0,0,0,0,0,0,0,0,0,0,1],
      [1,0,0,0,0,0,0,0,0,0,0,0,0,0,0,0,0,0,0,0,0,0,0,0,0,0,0,0,0,1],
      [1,0,0,0,0,0,0,0,0,0,0,0,0,0,0,0,0,0,0,0,0,0,0,0,0,0,0,0,0,1],
      [1,0,0,0,0,0,0,0,0,0,0,0,0,0,0,0,0,0,0,0,0,0,0,0,0,0,0,0,0,1],
      [1,0,0,0,0,0,0,0,0,0,0,0,0,0,0,0,0,0,0,0,0,0,0,0,0,0,0,0,0,1],
      [1,0,0,0,0,0,0,0,0,0,0,0,0,0,0,0,0,0,0,0,0,0,0,0,0,0,0,0,0,1],
      [1,0,0,0,0,0,0,0,0,0,0,0,0,0,0,0,0,0,0,0,0,0,0,0,0,0,0,0,0,1],
      [1,0,0,0,0,0,0,0,0,0,0,0,0,0,0,0,0,0,0,0,0,0,0,0,0,0,0,0,0,1],
      [1,0,0,0,0,0,0,0,0,0,0,0,0,0,0,0,0,0,0,0,0,0,0,0,0,0,0,0,0,1],
      [1,0,0,0,0,0,0,0,0,0,0,0,0,0,0,0,0,0,0,0,0,0,0,0,0,0,0,0,0,1],
      [1,0,0,0,0,0,0,0,0,0,0,0,0,0,0,0,0,0,0,0,0,0,0,0,0,0,0,0,0,1],
      [1,0,0,0,0,0,0,0,0,0,0,0,0,0,0,0,0,0,0,0,0,0,0,0,0,0,0,0,0,1],
      [1,0,0,0,0,0,0,0,0,0,0,0,0,0,0,0,0,0,0,0,0,0,0,0,0,0,0,0,0,1],
      [1,0,0,0,0,0,0,0,0,0,0,0,0,0,0,0,0,0,0,0,0,0,0,0,0,0,0,0,0,1],
      [1,0,0,0,0,0,0,0,0,0,0,0,0,0,0,0,0,0,0,0,0,0,0,0,0,0,0,0,0,1],
      [1,0,0,0,0,0,0,0,0,0,0,0,0,0,0,0,0,0,0,0,0,0,0,0,0,0,0,0,0,1],
      [1,0,0,0,0,0,0,0,0,0,0,0,0,0,0,0,0,0,0,0,0,0,0,0,0,0,0,0,0,1],
      [1,0,0,0,0,0,0,0,0,0,0,0,0,0,0,0,0,0,0,0,0,0,0,0,0,0,0,0,0,1],
      [1,0,0,0,0,0,0,0,0,0,0,0,0,0,0,0,0,0,0,0,0,0,0,0,0,0,0,0,0,1],
      [1,0,0,0,0,0,0,0,0,0,0,0,0,0,0,0,0,0,0,0,0,0,0,0,0,0,0,0,0,1],
      [1,0,0,0,0,0,0,0,0,0,0,0,0,0,0,0,0,0,0,0,0,0,0,0,0,0,0,0,0,1],
      [1,0,0,0,0,0,0,0,0,0,0,0,0,0,0,0,0,0,0,0,0,0,0,0,0,0,0,0,0,1],
      [1,0,0,0,0,0,0,0,0,0,0,0,0,0,0,0,0,0,0,0,0,0,0,0,0,0,0,0,0,1],
      [1,0,0,0,0,0,0,0,0,0,0,0,0,0,0,0,0,0,0,0,0,0,0,0,0,0,0,0,0,1],
      [1,0,0,0,0,0,0,0,0,0,0,0,0,0,0,0,0,0,0,0,0,0,0,0,0,0,0,0,0,1],
      [1,0,0,0,0,0,0,0,0,0,0,0,0,0,0,0,0,0,0,0,0,0,0,0,0,0,0,0,0,1],
      [1,0,0,0,0,0,0,0,0,0,0,0,0,0,0,0,0,0,0,0,0,0,0,0,0,0,0,0,0,1],
      [1,0,0,0,0,0,0,0,0,0,0,0,0,0,0,0,0,0,0,0,0,0,0,0,0,0,0,0,0,1],
      [1,1,1,1,1,1,1,1,1,1,1,1,1,1,1,1,1,1,1,1,1,1,1,1,1,1,1,1,1,1]
    ],
    "active": false,
    "approved": false
  }
]
